+-----------------------------------------------------------------------------------------------------+
||   k||                k|---|          |---|                    |--|          |--|                  ||
||    ||                 |---|          |---|                    |--|          |--|                  ||
||dDDD||    +-------+    |---|   +--+   |---|            +--+    |--|   +--+   |--|   +----------+   ||
||    ||    |-------|    |---|   |--|   |---|   +--+DDDDd|--|    |--|   |--|   |--|   |----------|   ||
||    ||    +-------+    |---|   |--|   |---|   |--|     |--|    |--|   |--|   |--|   |----------|   ||
||    ||                 |---|   |--|   |---|   |--|     |--|    |--|   |--|   |--|   |----------|   ||
||    ++                 +---+   |--|   |---|   |--|     |--|    |--|   |--|   |--|   |----------|   ||
||                               |--|   |---|   |--|     |--|    +--+   |--|   |--|   +----------+   ||
||    +----------------------+   |--|   |---|   |--|     |--|           |--|   |--|                  ||
||    +----------------------+   |--|   +---+   |--|     |--|           |--|   |--|                  ||
||                               |--|           |--|     |-----------------|   |--|   +--------------||
||    +--+                       |--|           |--|     +-----------------+   +--+   +--------------||
||    |--|                       +--+   +---+   |--|            |-|                                  ||
||    |--|                              |---|   |--|   +----+   |-|                                  ||
||    |--|     +--------------------+   |---|   |--|   +----+   |-|   +------------------+   +--+    ||
||    +--+     +--------------------+   |---|   |--|            |-|   +------------------|   |--|    ||
||                                      |---|   +--+     +-+    |-|     ||        |------|   |--|    ||
||----------------+   +--+   +--------------|            +-+    |-|          ++   |--|       |--|    ||
||----------------+   |--|   |--------------|  +-+    +-+       |-|          ||   +--+       |--|    ||
||                    |--|   +--------------|  +-+    +-+       |-----+   +------+           |--|    ||
||                    |--|                |-|       +-+         |-----+   |------+    +-+    |--|    ||
||     +-----------------|   +---------+  |-|       +-+         |-|       |---|      +--|    |--|    ||
||     +-----------------|   |---------|  |-|     +-+           |-|    +-----------------------------||
||                    |--|   |---------|  |-|     +-+   +-+     |-|    +-----------------------------||
||----------------+   |--|   |---------|  |-|   +-+     +-+     |-|       |--|                       ||
||----------------+   |--|   +---------+  +-+   +-+             |----+                               ||
||                    |--|                                      |----|                               ||
+-----------------------------------------------------------------------------------------------------+