++-----------------------------------------------------------++
++-----------------------------------------------------------++
||   ||   p    ||        |---| p ||                   |-|    ||
||   ||        ||        |---|   ||       +--------+  |-|    ||
||   ||   ++   ||   ++   |---|   ||   ++  |--------|  |-|    ||
||   ||   ||   ||   ||   |---|   ||   ||  |--------|  |-|    ||
||   ||   ||   ||   ||   +---+   ||   ||  |--------|  |-|    ||
||k  ||   ||   ||   ||           ||   ||  +--------+  |-|    ||
||   ||   ||   ||   ||           ||   ||          k   |-|    ||
||   ||   ||   ||   |-------------|   |-----------------|    ||
||   ||   ||   ||   +-------------+   |-----------------+DDDD||
||   ||   ||   ||                     ||  e                  ||
||   ||   ||   ||                     ||  e                  ||
||   ++   ||   |------------------+   |------------------+   ||
||        ||   +------------------+   +------------------+   ||
||        ||                          D                      ||
||   ++   ||                          D                      ||
||   ||   ||   +------------------+   +------------------+   ||
||   ||   ||   |------------------|   |------------------+   ||
||   ||   ||   ||       e       |-|   ||        ||           ||
||   ||   ||   ||       p       |-|   ||   ++   ||   ++      ||
||   ||   ||   ||   +-------+   |-|   ||   ||   ||   ||      ||
||   ||   ||   ||   |-------|   |-|   ||   ||   ||   ||      ||
||   ||   ||   ||   |-------|   |-|   ||   ||   ||   ||      ||
||   ||   ||   ||   |-------|   |-|   ||   ||   ||   ||      ||
||   ||   ||   ||   |-------|   |-|   ||   ||   ||   ||      ||
||   ||   ||   ++   +-------+   +-+   ++   ||   ++   ||      ||
||   ++   ||                               ||    e   ||      ||
||   p    ||                               ||    p   ||      ||
++-----------------------------------------------------------++
++-----------------------------------------------------------++