+-----------------------------------------------------------------------------------------------------+
+----------------------t------------------------------------------------++-----------++--t--------t---+
||     s  II             II   II                                    II  ||           ||              ||
||        ||        ++   ||   ||wwwwwwwwwwwwwwwwwwwwwwwwwwwwwwwwwwww||s ++           ||              ||
||       k|T        ||   ||   mmwwwwwwwwwwwwwwwwwwwwwwwwwwwwwwwwwwwwgg  d            ||      ++ ww w ||
||   +--I-++........||   ||   ||wwwwwwwwwwwwwwwwwwwwwwwwwwwwwwwwwwww||  D            ||ww    ||wwwwww||
||   +--IIII  h     ++   ||P  ||wwwwwwwwwwwwwwwwwwwwwwwwwwwwwwwwwwww||  D    ww      ||ww  ww||wwwwww||
||      ............     ++---++-------------------------------++-------++  www  ww w||wwwwww||wwwwww||
||      ...++-------++dDD++---++-----t-----------t-------------++-------++wwwwwwwwwww++wwwwww++wwwwww||
||      ...++-------++        ||                                d       wwwwwwwwwwwwwwwwwwwwwwwwww   ||
||      ...||p      ||   ++   |T                                D       wwwwwwwwwwwwwwwwwwwwwwwww    ||
|+------------------++---||   ||                      ++-------++-------++wwwwwwwwwwwwwwwwwww++ww    ||
|+--t--t---t---t---t---t-++   ||                      ++-------++-------++  ww      wwwwww   ||w     ||
||                            ||k                              |T                     ww     ||      ||
||   ++ +++ +++ +++ +++ +++   |+--------------------------+dDD+||                            ||     k||
|T                       ||   ++----0-9-7-4-8-2-6-1-3-5---+   +++----------------------------++------||
||                       ||   ++--------------------------+   +++------------------------------------||
|T                       ||   ||                               ||      gg      gg      gg      kIIIII||
||                      k||   ||   ++--||--++  ++--||--++  ++--|s  ++mm++mm++mm++mm++mm++mm++mm++---I||
||   ++ +++ +++ +++ +++ +++   ||   dDk0||1kDd  dDk2||3kDd  dDk4||  gg  gg  gg  gg  gg  gg  gg  gg    ||
|T                            ||   ++--||--++  ++--||--++  ++--||--++mm++mm++mm++mm++mm++mm++mm+++   ||
||                            ||   dDk5||6kDd  dDk7||8kDd  dDk9||--||      gg      gg      gg   ||   ||
||                            ||   ++--||--++  ++--||--++  ++--++ k++----------------------++   ||   ||
||                            ||   ++--||--++  ++--||--++  ++--++  ++----------------------++   ||   ||
|T                            ||                                   Dd                           II   ||
||     ++--------------------I|+----------------------------------------------------------------++dDD||
||     ++--------------------I++----------------------------------------------------------------++   ||
||T                            d    ++    ++    +T            ++      ..................             ||
|T                             D                         ++           ++k  ....                      ||
+-----------------------------------------------------------------------------------------------------+
+-----------------------------------------------------------------------------------------------------+