+-----------------------------------------------------------------------------------------------------+
+----------------------t------------------------------------------------++-----------++--t--------t---+
||     s  II             II   II                                    II  ||           ||              ||
||        ||        ++   ||   ||wwwwwwwwwwwwwwwwwwwwwwwwwwwwwwwwwwww||s ++           ||              ||
||        |T        ||   ||   mmwwwwwwwwwwwwwwwwwwwwwwwwwwwwwwwwwwwwgg               ||      ++ ww w ||
||   +----++........||   ||   ||wwwwwwwwwwwwwwwwwwwwwwwwwwwwwwwwwwww||               ||ww    ||wwwwww||
||   +----++........++   ||P  ||wwwwwwwwwwwwwwwwwwwwwwwwwwwwwwwwwwww||       ww      ||ww  ww||wwwwww||
||      ............     ++---++-------------------------------++-------++  www  ww w||wwwwww||wwwwww||
||      ...++-------++   ++---++-----t-----------t-------------++-------++wwwwwwwwwww++wwwwww++wwwwww||
||      ...++-------++        |T                                        wwwwwwwwwwwwwwwwwwwwwwwwww   ||
||      ...||p      ||   ++   ||                                        wwwwwwwwwwwwwwwwwwwwwwwww    ||
|+------------------++---||   ||                      ++-------++-------++wwwwwwwwwwwwwwwwwww++ww    ||
|+--t--t---t---t---t---t-++   ||                      ++-------++-------++  ww      wwwwww   ||w     ||
||                            ||                               |T                     ww     ||      ||
||   ++ +++ +++ +++ +++ +++   |+--------------------------+dDD+||                            ||      ||
|T                       ||   ++----0-9-7-4-8-2-6-1-3-5---+   +++----------------------------++------||
||                       ||   ++--------------------------+   +++------------------------------------||
|T                       ||   ||                               ||      gg      gg      gg      IIIIII||
||                      h||   ||   ++--||--++  ++--||--++  ++--|s  ++mm++mm++mm++mm++mm++mm++mm++---I||
||   ++ +++ +++ +++ +++ +++   ||   dDk0||1kDd  dDk2||3kDd  dDk4||  gg  gg  gg  gg  gg  gg  gg  gg    ||
|T                            ||   ++--||--++  ++--||--++  ++--||--++mm++mm++mm++mm++mm++mm++mm+++   ||
||                            ||   dDk5||6kDd  dDk7||8kDd  dDk9||--||      gg      gg      gg   ||   ||
||                            ||   ++--||--++  ++--||--++  ++--++ k++----------------------++   ||   ||
|T                            ||   ++--||--++  ++--||--++  ++--++  ++----------------------++   ||   ||
||                            ||                                                                II   ||
||     ++--------------------I|+----------------------------------------------------------------++   ||
||     ++--------------------I++----------------------------------------------------------------++   ||
||                                  ++    ++    +T            ++      ..................             ||
|T                                                       ++           ++   ....                      ||
+-----------------------------------------------------------------------------------------------------+
+-----------------------------------------------------------------------------------------------------+